####################
#S  ####       #####
#   ###         ####
##  #            ###
###       ##      ##
####     ####      #
###     ######    E#
#        ####     ##
#         ##    K###
##              ####
####################