####################
#S       #         #
# ###### # ####### #
# #    # # #     # #
# # ## # # # ### # #
#      #   # #E    #
####################